0		0		4620		4		0
0		0		2310		4		0
0		0		1155		4		0														
0		0		577		4		0
0		0		288		0		4		9	13	91	92
288		0		288		0		10		13	14	19 	22	23	24	87	92	93	94
0		288		288		0		12		2	11	4	5	6	7	8	10	9	91	106	107
288		288		288		0		6		12	14	16	17	10	107
577		0		577		4		0
577		0		288		0		15		18	20	21	22	24	25	26	27	28	29	30	86	94	108	109
865		0		288		0		12		29	30	31	32	36	37	38	35	94	109	96	112
577		288		288		0		7		15	16	10	18	107	108	97
865		288		288		0		7		35	38	39	40	41	42	96	
0		577		577		4		0
0		577		288		0		8		0	1	2	3	4	91	106	125
288		577		288		0		0
0		865		288		0		0
288		865		288		0		0
577		577		577		0		0
1155		0		1155		4		0
1155		0		577		4		0
1155		0		288		0		9		32	33	34	35	39	43	44	95	98
1443		0		288		0		3		44	45	98
1155		288		288		0		11		35	39	41	42	43	44	88	113	97	114	128
1443		288		288		0		12		42	44	45	46	47	48	49	50	97	100	114	128
1732		0		577		4		0
1732		0		288		0		0
2020		0		288		0		0
1732		288		288		0		6		47	48	55	56	99	101
2020		288		288		0		3		56	57	101
1155		577		577		4		0
1155		577		288		0		0
1443		577		288		0		6		50	51	52	100	102	115
1155		865		288		0		0
1443		865		288		0		0
1732		577		577		4		0
1732		577		288		0		6		52	53	54	59	102	115
2020		577		288		0		5		57	58	59	102	116
1732		865		288		0		0
2020		865		288		0		0
0		1155		1155		0		0
1155		1155		1155		0		0
2310		0		2310		4		0
2310		0		1155		4		0
2310		0		577		4		0
2310		0		288		0		3		65	104	105
2598		0		288		0		3		65	66	105
2310		288		288		0		7		57	60	61	62	65	101	104
2598		288		288		0		8		62	63	64	65	67	70	103	111
2887		0		517		4		0
2887		0		288		0		2		66	105
3175		0		288		0		3		66	105	129
2887		288		288		0		8		67	68	69	70	72	89	111	118
3175		288		288		0		6		71	72	73	74	89	111
2310		577		577		4		0
2310		577		288		0		7		57	59	61	62	102	117	124
2598		577		288		0		5		59	62	63	102	103
2310		865		288		0		0
2598		865		288		0		0
2887		577		577		0		0
3465		0		1155		4		0
3465		0		577		4		0
3465		0		288		0		4		66	76	77	105
3753		0		288		0		3		77	79	105
3465		288		288		0		5		75	76	78	111	120
3753		288		288		0		7		78	79	80	81	111	119	121	
4042		0		577		4		0
4042		0		288		0		1		105
4330		0		288		0		5		82	83	85	105	110
4042		288		288		0		5		80	81	111	122	123
4330		288		288		0		8		80	81	82	84	85	90	110	111
3465		577		577		0		0
4042		517		517		0		0
2310		1155		1155		0		0
3465		1155		1155		0		0
0		2310		2310		0		0
2310		2310		2310		0		0
